Greylancer OST - Stage 1 (Bass)

Tab by Brodan
Tuning: 5-String Standard (BEADG)

| /  slide up
| \  slide down
| h  hammer-on
| p  pull-off


riff 1 (0:00)
G|---------------------------------------------------------4-------|
D|-------------------------------------------------------5---7-5---|
A|-2-2-2-2-2-2-2-2-2-2-2-2-2-2-2---------------------2-5---------5-|
E|-------------------------------3-3-3-3-3-3-3-3-3-3---------------|
B|-----------------------------------------------------------------| x3

G|---------------------------------------------------------4-------|
D|-------------------------------------------------------5---7-5---|
A|-2-2-2-2-2-2-2-2-2-2-2-2-2-2-2---------------------2-5-----------|
E|-------------------------------3-3-3-3-3-3-3-3-3-3---------------|
B|---------------------------------------------------------------7-|

G|---------------------------------------------------------4-------|
D|-------------------------------------------------------5---7-5---|
A|-2-2-2-2-2-2-2-2-2-2-2-2-2-2-2---------------------2-5---------5-|
E|-------------------------------3-3-3-3-3-3-3-3-3-3---------------|
B|-----------------------------------------------------------------|
